Agrave=A+grave.cap@top
agrave=a+grave@top
Aacute=A+acute.cap@top
aacute=a+acute@top
Acircumflex=A+circumflex.cap@top
acircumflex=a+circumflex@top
Atilde=A+tilde.cap@top
atilde=a+tilde@top
Adieresis=A+dieresis.cap@top
adieresis=a+dieresis@top
Amacron=A+macron.cap@top
amacron=a+macron@top
Abreve=A+breve.cap@top
abreve=a+breve@top
Aring=A+ring.cap@top
aring=a+ring@top
Aringacute=A+ring_acute.cap@top
aringacute=a+ring_acute@top
Adotbelow=A+dotbelow@bottom
adotbelow=a+dotbelow@bottom
Aogonek=A+ogonek@ogonek
aogonek=a+ogonek@ogonek
AEacute=AE+acute.cap@top
aeacute=ae+acute@top
Cacute=C+acute.cap@top
cacute=c+acute@top
Ccircumflex=C+circumflex.cap@top
ccircumflex=c+circumflex@top
Ccaron=C+caron.cap@top
ccaron=c+caron@top
Cdotaccent=C+dotaccent.cap@top
cdotaccent=c+dotaccent@top
Ccedilla=C+cedilla@bottom
ccedilla=c+cedilla@bottom
Dcaron=D+caron.cap@top
dcaron=d+caron.alt@caron.alt
Egrave=E+grave.cap@top
egrave=e+grave@top
Eacute=E+acute.cap@top
eacute=e+acute@top
Ecircumflex=E+circumflex.cap@top
ecircumflex=e+circumflex@top
Etilde=E+tilde.cap@top
etilde=e+tilde@top
Ecaron=E+caron.cap@top
ecaron=e+caron@top
Edieresis=E+dieresis.cap@top
edieresis=e+dieresis@top
Emacron=E+macron.cap@top
emacron=e+macron@top
Ebreve=E+breve.cap@top
ebreve=e+breve@top
Edotaccent=E+dotaccent.cap@top
edotaccent=e+dotaccent@top
Edotbelow=E+dotbelow@bottom
edotbelow=e+dotbelow@bottom
Eogonek=E+ogonek@ogonek
eogonek=e+ogonek@ogonek
Gcircumflex=G+circumflex.cap@top
gcircumflex=g+circumflex@top
Gcaron=G+caron.cap@top
gcaron=g+caron@top
Gbreve=G+breve.cap@top
gbreve=g+breve@top
Gdotaccent=G+dotaccent.cap@top
gdotaccent=g+dotaccent@top
Gcommaaccent=G+commaaccent@bottom
gcommaaccent=g+commaaccent.alt@top
Hcircumflex=H+circumflex.cap@top
hcircumflex=h+circumflex@top
Igrave=I+grave.cap@top
igrave=dotlessi+grave@top
Iacute=I+acute.cap@top
iacute=dotlessi+acute@top
Icircumflex=I+circumflex.cap@top
icircumflex=dotlessi+circumflex@top
Itilde=I+tilde.cap@top
itilde=dotlessi+tilde@top
Idieresis=I+dieresis.cap@top
idieresis=dotlessi+dieresis@top
Imacron=I+macron.cap@top
imacron=dotlessi+macron@top
Ibreve=I+breve.cap@top
ibreve=dotlessi+breve@top
Idotaccent=I+dotaccent.cap@top
Idotbelow=I+dotbelow@bottom
idotbelow=i+dotbelow@bottom
Iogonek=I+ogonek@ogonek
iogonek=i+ogonek@ogonek
Jcircumflex=J+circumflex.cap@top
jcircumflex=dotlessj+circumflex@top
Kcommaaccent=K+commaaccent@bottom
kcommaaccent=k+commaaccent@bottom
Lacute=L+acute.cap@top
lacute=l+acute@top
Lcaron=L+caron.alt@caron.alt
lcaron=l+caron.alt@caron.alt
Lcommaaccent=L+commaaccent@bottom
lcommaaccent=l+commaaccent@bottom
Nacute=N+acute.cap@top
nacute=n+acute@top
Ntilde=N+tilde.cap@top
ntilde=n+tilde@top
Ncaron=N+caron.cap@top
ncaron=n+caron@top
Ncommaaccent=N+commaaccent@bottom
ncommaaccent=n+commaaccent@bottom
Ograve=O+grave.cap@top
ograve=o+grave@top
Oacute=O+acute.cap@top
oacute=o+acute@top
Ocircumflex=O+circumflex.cap@top
ocircumflex=o+circumflex@top
Otilde=O+tilde.cap@top
otilde=o+tilde@top
Odieresis=O+dieresis.cap@top
odieresis=o+dieresis@top
Omacron=O+macron.cap@top
omacron=o+macron@top
Obreve=O+breve.cap@top
obreve=o+breve@top
Ohungarumlaut=O+hungarumlaut.cap@top
ohungarumlaut=o+hungarumlaut@top
Odotbelow=O+dotbelow@bottom
odotbelow=o+dotbelow@bottom
Oslashacute=Oslash+acute.cap@top
oslashacute=oslash+acute@top
Racute=R+acute.cap@top
racute=r+acute@top
Rcaron=R+caron.cap@top
rcaron=r+caron@top
Rcommaaccent=R+commaaccent@bottom
rcommaaccent=r+commaaccent@bottom
Sacute=S+acute.cap@top
sacute=s+acute@top
Scircumflex=S+circumflex.cap@top
scircumflex=s+circumflex@top
Scaron=S+caron.cap@top
scaron=s+caron@top
Scedilla=S+cedilla@bottom
scedilla=s+cedilla@bottom
Scommaaccent=S+commaaccent@bottom
scommaaccent=s+commaaccent@bottom
Tcaron=T+caron.cap@top
tcaron=t+caron.alt@caron.alt
Ugrave=U+grave.cap@top
ugrave=u+grave@top
Uacute=U+acute.cap@top
uacute=u+acute@top
Ucircumflex=U+circumflex.cap@top
ucircumflex=u+circumflex@top
Utilde=U+tilde.cap@top
utilde=u+tilde@top
Udieresis=U+dieresis.cap@top
udieresis=u+dieresis@top
Umacron=U+macron.cap@top
umacron=u+macron@top
Ubreve=U+breve.cap@top
ubreve=u+breve@top
Uring=U+ring.cap@top
uring=u+ring@top
Uhungarumlaut=U+hungarumlaut.cap@top
uhungarumlaut=u+hungarumlaut@top
Udotbelow=U+dotbelow@bottom
udotbelow=u+dotbelow@bottom
Uogonek=U+ogonek@ogonek
uogonek=u+ogonek@ogonek
Wgrave=W+grave.cap@top
wgrave=w+grave@top
Wacute=W+acute.cap@top
wacute=w+acute@top
Wcircumflex=W+circumflex.cap@top
wcircumflex=w+circumflex@top
Wdieresis=W+dieresis.cap@top
wdieresis=w+dieresis@top
Ygrave=Y+grave.cap@top
ygrave=y+grave@top
Yacute=Y+acute.cap@top
yacute=y+acute@top
Ycircumflex=Y+circumflex.cap@top
ycircumflex=y+circumflex@top
Ytilde=Y+tilde.cap@top
ytilde=y+tilde@top
Ydieresis=Y+dieresis.cap@top
ydieresis=y+dieresis@top
Ymacron=Y+macron.cap@top
ymacron=y+macron@top
Zacute=Z+acute.cap@top
zacute=z+acute@top
Zcaron=Z+caron.cap@top
zcaron=z+caron@top
Zdotaccent=Z+dotaccent.cap@top
zdotaccent=z+dotaccent@top
